Donna's finger grazed the pink button before tentatively settling on the green one. With a faint whirring sound, the room began to whirl around her. Before she knew it, she was sitting at a large oak desk in a round office. She shook her head to clear her vision, and that was when she saw the large, framed portrait hanging on the wall. Donna Bricolo, it said. 46th President of the United States. What's going on? She asked herself. How did I get here?

Green Button
An Interactive Fiction by Douglas Kiang
Release 1 / Serial number 170214 / Inform 7 build 6M62 (I6/v6.33 lib 6/12N) SD

Oval Office
You can see Oak Door and Brass Key here.

>open door
It seems to be locked.

>unlock door
(with Oak Door)
(first taking Oak Door)
That's fixed in place.

>open door
It seems to be locked.

>l
Oval Office
You can see Oak Door here.

* * *

>take key
Taken.

>unlock door
(with Brass Key)
You unlock Oak Door.

>open door
You open Oak Door.

>s
Front Lawn

>n
Oval Office
You can see Oak Door here.

>n
Hallway
You can see Oak Door here.

>n
Garden

* * *

>unlock door
What do you want to unlock Oak Door with?

>brass key
You can't see any such thing.

>brasskey
That's not a verb I recognise.

>key
That's not a verb I recognise.

>unlock door with key
You can't see any such thing.

>l
Oval Office
You can see Oak Door and Brass Key here.

>take key
You can't see any such thing.

>take brasskey
Taken.